,0,1,2,3,4,5,6,7,8,9,10,11,12,13,14,15,16,17,18,19,20,21,22,23,24,25,26,27,28
106,-1,-1,-1,-1,-1,-1,-1,-1,-1,-1,-1,-1,-1,-1,-1,-1,-1,-1,-1,-1,-1,-1,-1,-1,-1,-1,-1,-1,-1
107,-1,-1,-1,-1,-1,-1,-1,27399,27400,27401,27402,27403,27404,27405,27406,27407,27408,-1,-1,-1,-1,-1,-1,-1,-1,-1,-1,-1,-1
108,-1,-1,-1,-1,-1,-1,-1,27655,-1,-1,-1,-1,-1,-1,-1,-1,27664,-1,-1,-1,-1,-1,-1,-1,-1,-1,-1,-1,-1
109,-1,-1,-1,-1,-1,-1,-1,27911,-1,-1,-1,-1,-1,-1,-1,-1,27920,-1,-1,-1,-1,-1,-1,-1,-1,-1,-1,-1,-1
110,-1,-1,-1,-1,-1,-1,-1,28167,-1,-1,-1,-1,-1,-1,-1,-1,28176,-1,-1,-1,-1,-1,-1,-1,-1,-1,-1,-1,-1
111,-1,-1,-1,-1,-1,-1,-1,28423,-1,-1,-1,-1,-1,-1,-1,-1,28432,28433,28434,28435,28436,-1,-1,-1,-1,-1,-1,-1,-1
112,28672,28673,28674,28675,28676,28677,28678,28679,-1,-1,-1,-1,-1,-1,-1,-1,-1,-1,-1,-1,28692,-1,-1,-1,-1,-1,-1,-1,-1
113,28928,-1,-1,-1,-1,-1,-1,-1,-1,-1,-1,-1,-1,-1,-1,-1,-1,-1,-1,-1,28948,-1,-1,-1,-1,-1,-1,-1,-1
114,29184,-1,-1,-1,-1,-1,-1,-1,-1,-1,-1,-1,-1,-1,-1,-1,-1,-1,-1,-1,29204,-1,-1,-1,-1,-1,-1,-1,-1
115,29440,-1,-1,-1,-1,-1,-1,-1,-1,-1,-1,-1,-1,-1,-1,-1,-1,-1,-1,-1,29460,-1,-1,-1,-1,-1,-1,-1,-1
116,-1,29697,29698,29699,29700,29701,29702,29703,29704,29705,29706,29707,-1,-1,-1,-1,-1,-1,-1,-1,29716,-1,-1,-1,-1,-1,-1,-1,-1
117,-1,-1,-1,-1,-1,-1,-1,-1,-1,-1,-1,29963,-1,-1,-1,-1,-1,-1,-1,-1,29972,-1,-1,-1,-1,-1,-1,-1,-1
118,-1,-1,-1,-1,-1,-1,-1,-1,-1,-1,-1,30219,-1,-1,-1,-1,-1,-1,-1,-1,30228,-1,-1,-1,-1,-1,-1,-1,-1
119,-1,-1,-1,-1,-1,-1,-1,-1,-1,-1,-1,30475,-1,-1,-1,-1,-1,-1,-1,-1,30484,30485,30486,30487,30488,-1,-1,-1,-1
120,-1,-1,-1,-1,-1,-1,-1,-1,-1,-1,-1,30731,30732,30733,30734,30735,-1,-1,-1,-1,-1,-1,-1,-1,30744,-1,-1,-1,-1
121,-1,-1,-1,-1,-1,-1,-1,-1,-1,-1,-1,-1,-1,-1,-1,30991,-1,-1,-1,-1,-1,-1,-1,-1,31000,-1,-1,-1,-1
122,-1,-1,-1,-1,-1,-1,-1,-1,-1,-1,-1,-1,-1,-1,-1,31247,-1,-1,-1,-1,-1,-1,-1,-1,31256,-1,-1,-1,-1
123,-1,-1,-1,-1,-1,-1,-1,-1,-1,-1,-1,-1,-1,-1,-1,31503,-1,-1,-1,-1,-1,-1,-1,-1,31512,-1,-1,-1,-1
124,-1,-1,-1,-1,-1,-1,-1,-1,-1,-1,-1,-1,-1,-1,-1,31759,31760,31761,31762,31763,-1,-1,-1,-1,31768,-1,-1,-1,-1
125,-1,-1,-1,-1,-1,-1,-1,-1,-1,-1,-1,-1,-1,-1,-1,-1,-1,-1,-1,32019,-1,-1,-1,-1,32024,-1,-1,-1,-1
126,-1,-1,-1,-1,-1,-1,-1,-1,-1,-1,-1,-1,-1,-1,-1,-1,-1,-1,-1,32275,-1,-1,-1,-1,32280,-1,-1,-1,-1
127,-1,-1,-1,-1,-1,-1,-1,-1,-1,-1,-1,32523,32524,32525,32526,32527,32528,32529,32530,32531,-1,-1,-1,-1,32536,-1,-1,-1,-1
128,-1,-1,-1,-1,-1,-1,-1,-1,-1,-1,-1,32779,-1,-1,-1,-1,-1,-1,-1,-1,-1,-1,-1,-1,32792,-1,-1,-1,-1
129,-1,-1,-1,-1,-1,-1,-1,-1,-1,-1,-1,33035,-1,-1,-1,-1,-1,-1,-1,-1,-1,-1,-1,-1,33048,-1,-1,-1,-1
130,-1,-1,-1,-1,-1,-1,-1,-1,-1,-1,-1,33291,-1,-1,-1,-1,-1,-1,-1,-1,-1,-1,-1,-1,33304,-1,-1,-1,-1
131,-1,-1,-1,-1,-1,-1,-1,-1,-1,-1,-1,33547,-1,-1,-1,-1,-1,-1,-1,-1,-1,-1,-1,-1,33560,-1,-1,-1,-1
132,-1,-1,-1,-1,-1,-1,-1,-1,-1,-1,-1,33803,-1,-1,-1,-1,-1,-1,-1,-1,33812,33813,33814,33815,33816,-1,-1,-1,-1
133,-1,-1,-1,-1,-1,-1,-1,-1,-1,-1,-1,34059,-1,-1,-1,-1,-1,-1,-1,-1,34068,-1,-1,-1,-1,-1,-1,-1,-1
134,-1,-1,-1,-1,-1,-1,-1,-1,-1,-1,-1,34315,-1,-1,-1,-1,-1,-1,-1,-1,34324,-1,-1,-1,-1,-1,-1,-1,-1
135,-1,-1,-1,-1,-1,-1,-1,34567,34568,34569,34570,34571,-1,-1,-1,-1,-1,-1,-1,-1,34580,34581,34582,34583,34584,34585,34586,34587,34588
136,-1,-1,-1,-1,-1,-1,-1,34823,-1,-1,-1,-1,-1,-1,-1,-1,-1,-1,-1,-1,-1,-1,-1,-1,-1,-1,-1,-1,34844
137,-1,-1,-1,-1,-1,-1,-1,35079,-1,-1,-1,-1,-1,-1,-1,-1,-1,-1,-1,-1,-1,-1,-1,-1,-1,-1,-1,-1,35100
138,-1,-1,-1,-1,-1,-1,-1,35335,-1,-1,-1,-1,-1,-1,-1,-1,-1,-1,-1,-1,-1,-1,-1,-1,-1,-1,-1,-1,35356
139,-1,-1,-1,-1,-1,-1,-1,35591,-1,-1,-1,-1,-1,-1,-1,-1,-1,-1,-1,-1,-1,-1,-1,-1,-1,-1,-1,-1,35612
140,-1,-1,-1,-1,-1,-1,-1,35847,-1,-1,-1,-1,-1,-1,-1,-1,35856,35857,35858,35859,35860,35861,35862,35863,35864,35865,35866,35867,35868
141,-1,-1,-1,-1,-1,-1,-1,36103,-1,-1,-1,-1,-1,-1,-1,-1,36112,-1,-1,-1,-1,-1,-1,-1,-1,-1,-1,-1,36124
142,-1,-1,-1,-1,-1,-1,-1,36359,-1,-1,-1,-1,-1,-1,-1,-1,36368,-1,-1,-1,-1,-1,-1,-1,-1,-1,-1,-1,36380
143,36608,36609,36610,36611,36612,36613,36614,36615,-1,-1,-1,-1,-1,-1,-1,-1,36624,-1,-1,-1,-1,-1,-1,-1,-1,-1,-1,-1,36636
144,-1,-1,-1,-1,-1,-1,-1,-1,-1,-1,-1,-1,36876,36877,36878,36879,36880,-1,-1,-1,-1,-1,-1,-1,-1,-1,-1,-1,36892
145,-1,-1,-1,-1,-1,-1,-1,-1,-1,-1,-1,-1,37132,-1,-1,-1,-1,-1,-1,-1,-1,-1,-1,-1,-1,-1,-1,-1,37148
146,-1,-1,-1,-1,-1,-1,-1,-1,-1,-1,-1,-1,37388,-1,-1,-1,-1,-1,-1,-1,-1,-1,-1,-1,-1,-1,-1,-1,37404
147,-1,-1,-1,-1,-1,-1,-1,-1,-1,-1,-1,-1,37644,-1,-1,-1,-1,-1,-1,-1,-1,-1,-1,-1,-1,-1,-1,-1,37660
148,37888,37889,37890,37891,37892,37893,37894,37895,37896,37897,37898,37899,37900,-1,-1,-1,-1,-1,-1,-1,-1,-1,-1,-1,-1,-1,-1,-1,37916
,1184,,,,,,,,,,,,,,,,,,,,,,,,,,,,
